111111111111111111111111111111111111111111111111
1C00000000000000000000000000000000000000000000C1
100000000111100000111110001111100011111000000001
10000000010010000000001000000010001C001000000001
100000000000100000111110001111100000001000000001
100000000000100000000010000000100000001000000001
100000000011111000111110001111100000001000000001
1E00000000000000P00000000000000000000000000000C1
111111111111111111111111111111111111111111111111