1111111111
1E00100001
10000000C1
10C0011P11
1111111111
